15
A07000000000000
007000070000000
777003009000000
00000000000000A
000000000000000
000000000000000
004000009000000
0000A00H0000000
006000000000000
000000080000000
A00000000000000
000000000000000
000000000000030
000000000000000
00100000H000000
