7 12
############
#9 2 #4#4  #
####1# ###1#
#3 1 #3 2 1#
###1######1#
#3 1 1 1 1X#
############
