21 21
#####################
X       #5  #3  # #5#
####### # # ### # #6#
#7#   #   # #  9#   #
# ### # ##### ##### #
#52    3  # #7#   # #
# ### ### # # # ### #
#9#2  #    6  #     #
###1# ###9####### ###
#6#6#5  #     #    5#
# ##### ### # ### ###
# #   # # # # #   #2#
#5### #3# ### ### # #
#     #3# #     #   #
### #7# # ##### ### #
#3# #1 6#   # # # # #
# # ### ### # # # # #
# 2 # # #  5#    23 #
### # # # ### ### # #
#6  #   #4   4  #6#9#
#####################
