1 4
11 13
16 16
################
#....#....#....#
#.++++.++++.++.#
#.+..+.+..X.+..#
#.|.++X+.++++++#
#....X.+.#.....#
#.++++.+X+++++.#
#....+...+.....#
##+++++-.+++++##
#.....+...|....#
#.+++++++...++##
#.+.+.+...+.+..#
#.+X+...+.+.++.#
#.|.++++++-..+.#
#..........#...#
################
