16
9
################
#____#Z#__W__#X#
#_##y#_#____t#_#
#Sz###_#######_#
#_##w#x#Y___u#_#
#____###_____#_#
##############_#
#E____U__T_____#
################
