##########
#..M#C...#
#...##...#
###..#.###
#.##.#...#
#.....#..#
#.....#..#
#.....#..#
#........#
##########
