8
................
................
................
................
................
................
...../\../\.....
/\/\/\/\/\/\/\/\
