A37100000001111
337100070001222
777103009001233
11110000000123A
011155555551233
012255555551222
014355559551111
1123A55H5550000
226355555550000
332255585550000
A32155555550000
332105555555000
222105555555030
111105555555000
00100555H555000
